4
1 12
12 1
**************
*o           *
*            *
*            *
*            *
*            *
*            *
*            *
*            *
*            *
*            *
*            *
*           o*
**************