7	
1 12
9 1
***************
*             *
* ** ***** ** *
* ** ** ** ** *
*             *
* ** *   * ** *
* ** **o** ** *
*    *****    *
* ** **o** ** *
* ** ** ** ** *
*             *
***************