4
1 9
9 1
***********
*         *
* **** ** *
* **** ** *
* *** o** *
* *** *** *
* *** *** *
* **  ***o*
* **  *** *
*  o      *
***********